6,6,6,6,6,1,6,6,6,6,6,6,6,6,7,6,6,6,6,6,6,6,6,6,6,6,6,6,6,6
6,6,6,5,6,1,6,6,3,6,6,7,6,6,6,6,6,1,6,6,6,4,6,6,6,6,6,6,3,3
6,6,1,6,6,6,6,3,6,6,6,7,6,6,6,6,6,6,2,6,6,6,6,6,6,6,3,3,3,6
6,6,6,6,6,6,6,6,6,2,6,6,6,6,6,6,6,6,7,6,3,3,3,3,3,3,3,4,6,6
6,6,6,7,6,6,6,3,6,6,5,6,6,6,6,1,6,6,7,3,3,3,3,3,3,6,6,6,6,6
6,6,6,1,6,6,2,6,6,6,6,6,6,6,3,6,6,4,3,3,3,7,6,6,6,6,6,6,6,6
6,6,7,6,6,6,6,6,6,6,6,5,6,6,6,6,4,3,3,6,6,6,6,6,6,6,6,6,6,6
6,6,6,6,6,3,6,6,6,6,6,6,6,6,7,4,3,3,6,6,6,6,6,6,6,6,6,6,6,6
6,6,6,6,6,6,6,6,6,6,6,6,6,6,4,3,3,6,6,7,6,6,6,6,6,6,6,6,6,6
4,1,1,1,1,6,6,6,1,1,1,6,6,6,3,3,6,6,6,1,6,6,6,6,6,6,6,6,6,6
6,6,6,6,6,6,6,6,6,6,1,1,6,6,3,3,6,6,6,6,6,6,6,6,6,6,6,6,6,6
6,6,6,6,6,6,6,6,6,6,6,1,4,4,3,3,3,6,6,6,6,6,6,6,6,6,6,6,6,6
6,6,6,6,6,5,6,6,6,6,1,1,4,0,0,4,1,3,7,6,6,6,6,6,6,7,6,6,6,6
6,6,7,5,3,6,6,6,5,1,1,5,0,0,0,1,1,4,3,3,6,6,6,6,6,7,6,6,6,6
6,6,3,3,3,3,6,6,6,6,1,1,1,1,1,1,6,6,6,3,3,6,6,6,6,5,6,6,6,6
6,6,6,6,3,6,6,6,6,6,6,6,6,6,6,6,6,6,6,3,3,6,6,6,6,6,6,6,6,6
