6,6,6,1,6,6,6,6,2,6,6,3,6,6,6,6,6,4,6,6,6,6,6,5,6,6,6,3,6,6
6,6,1,2,6,6,6,6,6,4,6,6,6,5,6,6,6,2,6,6,6,6,6,1,6,3,6,6,5,6
6,1,6,6,6,2,6,3,6,4,6,6,6,1,6,3,6,6,5,6,6,2,1,6,4,6,6,5,6,6
6,6,6,1,1,6,6,6,6,5,6,4,6,6,2,6,3,6,6,6,6,3,1,6,2,6,6,3,6,6
6,6,2,6,6,6,6,5,6,6,6,6,6,6,2,1,6,6,6,5,6,6,6,1,6,5,6,6,3,6
6,6,6,6,6,2,3,6,6,6,6,6,6,6,4,6,2,5,6,4,6,6,3,6,6,1,6,5,6,6
6,6,3,6,6,6,6,6,4,5,6,6,2,6,1,6,6,6,5,6,6,6,2,6,6,6,6,4,6,6
6,3,6,5,6,6,6,4,6,6,6,1,6,6,6,6,6,6,2,3,6,2,4,6,6,6,6,6,6,6
6,6,6,6,6,6,6,5,4,6,6,1,6,5,5,6,6,6,6,6,6,6,6,6,6,4,6,6,3,6
6,6,6,5,6,1,6,6,6,6,6,3,6,6,5,5,6,2,6,6,6,6,6,5,6,6,6,6,6,3
6,2,3,6,6,5,6,6,6,1,6,6,6,6,3,6,6,6,6,1,6,6,6,3,6,2,6,3,4,6
6,6,3,6,6,6,2,6,5,6,6,6,6,6,6,5,6,2,6,4,6,6,6,6,6,6,6,6,6,6
6,6,6,6,6,1,6,2,6,6,3,6,6,4,5,5,5,6,6,6,6,6,1,6,6,6,6,6,5,6
6,6,6,6,6,6,2,6,6,6,6,6,6,1,6,6,6,6,6,6,3,6,6,4,6,6,6,6,2,6
6,5,6,6,6,6,6,5,6,4,1,6,6,6,6,6,3,6,6,6,6,6,1,4,6,5,6,6,2,6
6,6,6,6,6,6,6,6,6,3,1,2,6,6,6,6,5,6,6,4,6,6,6,2,6,6,6,6,6,6