59,42,42,42,42,42,42,59
42,42,42,42,42,42,42,42
42,42,59,42,42,42,42,42
42,42,59,59,42,42,42,59
42,42,42,59,59,42,59,59
42,42,42,59,42,42,42,59
59,42,42,42,42,42,42,59
59,59,42,42,42,42,42,59
